NO ./textures/north3.xpm
SO ./textures/south3.xpm
EA ./textures/east3.xpm
WE ./textures/west3.xpm

C 94, 172, 255
F 245, 155, 59

111111
100101
101001
1100N1
111111